{
    "C4": 48,
    "C4#": 49,
    "D4": 50,
    "E4": 52,
    "C5": 60,
    "D5": 62,
    "E5": 64,
    "F5": 65,
    "G5": 67,
    "A5": 69,
    "B5": 71
}